1111111111111111111
1001000000000000001
1111111110110000011
1000000000110000011
1111011111111101111
1111011111111101111
1100000011010101111
10000E0000000000000000001
1001
1001
1001
1001
1001
111111