1111111111111111111111111111111111111111
1000N00011111100010000000000000000000001
1110000101011101011111111111111111111111
1110001011000000010000000000000000000001
1110010001011111110000000000000000000001
1110100001000000000000000000000000000001
1110101111011111110000000000000000000001
1110000000000000000000000000000000000001
1110111111111111110000000000000000000001
1111111111111111110111111111111111111111
1110111111111111110000000000000000000001
1111111111111111110111111111111111111111
1110111111111111110000000000000000000001
1111111111111111110111111111111111111111
1110111111111111110000000000000000000001
1111111111111111111111111111111111111111